.....###.....
..@..###.....
.....###.....
.....###.....
.....###.....
#############
#############
#############
.....###.....
.....###.....
.....###.....
.....###.....
.....###.....