False
.................................
.##..##..####..##....##....######
.##..##..##....##....##....##..##
.######..####@.##....##....##..##
.##..##..##....##....##....##..##
.##..##..####..####..####..######
.................................
