####.g.####
#....q.d.g#
#..qd..g..#
#..#.g.#..#
..qqd.q..+.
.d.....d..q
q...d..q +.
#..#...d.@#
#.g.d....+#
#.....g...#
####...####