True
####...####
#@........#
#.........#
#..#...#..#
....d......
.d.....d...
...........
#..#...d..#
#...d.....#
#.....g...#
####...####