True
####.g.####
#....q.d.g#
#..qd..g..#
#..#.g.#..#
..qqd.q....
.d.....d..q
q...d......
#..#...d..#
#.g.d.....#
#.....g..@#
####...####