True
####...####
#.........#
#.........#
#..#...#..#
..qqd.q....
.d.....d...
...........
#..#...d..#
#...d.....#
#.....g..@#
####...####